//MAP CONVERTED BY dmm2tgm.py THIS HEADER COMMENT PREVENTS RECONVERSION, DO NOT REMOVE
"aa" = (
/obj/effect/decal/cleanable/dirt,
/turf/open/floor/white,
/area/bigredv2/outside/marshal_office)
"ab" = (
/turf/open/floor/white,
/area/bigredv2/outside/marshal_office)
"ac" = (
/obj/structure/surface/table,
/turf/open/floor/white,
/area/bigredv2/outside/marshal_office)
"af" = (
/obj/structure/surface/table,
/obj/effect/decal/cleanable/dirt,
/turf/open/floor/white,
/area/bigredv2/outside/marshal_office)
"ah" = (
/turf/closed/wall/solaris/reinforced,
/area/bigredv2/outside/marshal_office)
"ai" = (
/turf/closed/wall/solaris/rock,
/area/bigredv2/caves)
"aj" = (
/turf/open/mars,
/area/bigredv2/outside/n)
"ak" = (
/obj/structure/pipes/vents/pump,
/obj/effect/landmark/objective_landmark/close,
/turf/open/floor/white,
/area/bigredv2/outside/marshal_office)
"al" = (
/obj/effect/decal/cleanable/dirt,
/turf/open/floor/whitegreen/east,
/area/bigredv2/outside/marshal_office)
"am" = (
/obj/structure/sink{
	pixel_y = 32
	},
/turf/open/floor/freezerfloor,
/area/bigredv2/outside/marshal_office)
"ap" = (
/obj/structure/pipes/standard/simple/hidden/green,
/turf/open/floor/white,
/area/bigredv2/outside/marshal_office)
"aq" = (
/turf/open/floor/freezerfloor,
/area/bigredv2/outside/marshal_office)
"ar" = (
/obj/structure/machinery/camera/autoname{
	dir = 8
	},
/turf/open/floor/freezerfloor,
/area/bigredv2/outside/marshal_office)
"at" = (
/turf/closed/wall/solaris,
/area/bigredv2/outside/marshal_office)
"aw" = (
/obj/structure/bed,
/turf/open/floor/white,
/area/bigredv2/outside/marshal_office)
"ax" = (
/obj/structure/surface/table,
/obj/structure/machinery/light{
	dir = 8
	},
/turf/open/floor/white,
/area/bigredv2/outside/marshal_office)
"ay" = (
/obj/structure/machinery/light{
	dir = 4
	},
/turf/open/floor/freezerfloor,
/area/bigredv2/outside/marshal_office)
"az" = (
/obj/structure/surface/table,
/obj/structure/machinery/camera/autoname{
	dir = 1
	},
/turf/open/floor/white,
/area/bigredv2/outside/marshal_office)
"aA" = (
/obj/structure/toilet{
	dir = 4
	},
/obj/effect/landmark/monkey_spawn,
/turf/open/floor/freezerfloor,
/area/bigredv2/outside/marshal_office)
"aB" = (
/obj/structure/machinery/flasher/portable,
/turf/open/floor/vault2/west,
/area/bigredv2/outside/marshal_office)
"aD" = (
/obj/structure/closet/l3closet/security,
/turf/open/floor/vault2/west,
/area/bigredv2/outside/marshal_office)
"aN" = (
/obj/effect/decal/cleanable/dirt,
/turf/open/floor/dark,
/area/bigredv2/outside/marshal_office)
"aO" = (
/obj/effect/landmark/hunter_secondary,
/turf/open/floor/redcorner/east,
/area/bigredv2/outside/marshal_office)
"aP" = (
/obj/effect/decal/cleanable/dirt,
/turf/open/floor/redcorner/east,
/area/bigredv2/outside/marshal_office)
"aQ" = (
/obj/structure/pipes/standard/simple/hidden/green,
/turf/open/floor/redcorner/east,
/area/bigredv2/outside/marshal_office)
"aR" = (
/turf/open/floor/redcorner/east,
/area/bigredv2/outside/marshal_office)
"aY" = (
/obj/effect/decal/cleanable/dirt,
/turf/open/floor,
/area/bigredv2/outside/marshal_office)
"aZ" = (
/obj/effect/decal/cleanable/dirt,
/obj/effect/landmark/crap_item,
/turf/open/floor,
/area/bigredv2/outside/marshal_office)
"ba" = (
/obj/structure/pipes/standard/simple/hidden/green{
	dir = 5
	},
/turf/open/floor,
/area/bigredv2/outside/marshal_office)
"bb" = (
/obj/structure/pipes/standard/simple/hidden/green{
	dir = 4
	},
/obj/effect/decal/cleanable/dirt,
/turf/open/floor,
/area/bigredv2/outside/marshal_office)
"bc" = (
/obj/structure/pipes/standard/simple/hidden/green{
	dir = 4
	},
/obj/effect/decal/cleanable/dirt,
/obj/effect/decal/cleanable/dirt,
/turf/open/floor,
/area/bigredv2/outside/marshal_office)
"bd" = (
/obj/structure/pipes/standard/simple/hidden/green{
	dir = 10
	},
/turf/open/floor,
/area/bigredv2/outside/marshal_office)
"bg" = (
/obj/structure/pipes/standard/simple/hidden/green,
/turf/open/floor/dark,
/area/bigredv2/outside/marshal_office)
"bh" = (
/obj/structure/machinery/light,
/turf/open/floor/redcorner,
/area/bigredv2/outside/marshal_office)
"bi" = (
/turf/open/floor/redcorner,
/area/bigredv2/outside/marshal_office)
"bj" = (
/obj/effect/decal/cleanable/dirt,
/obj/structure/machinery/camera/autoname{
	dir = 1
	},
/turf/open/floor/redcorner,
/area/bigredv2/outside/marshal_office)
"bk" = (
/obj/effect/decal/cleanable/dirt,
/turf/open/floor/redcorner,
/area/bigredv2/outside/marshal_office)
"bl" = (
/obj/effect/decal/cleanable/dirt,
/obj/effect/landmark/good_item,
/turf/open/floor/redcorner,
/area/bigredv2/outside/marshal_office)
"bn" = (
/obj/structure/pipes/standard/simple/hidden/green,
/obj/effect/decal/cleanable/dirt,
/turf/open/floor/redcorner,
/area/bigredv2/outside/marshal_office)
"bp" = (
/obj/structure/pipes/standard/simple/hidden/green,
/obj/structure/machinery/door/airlock/almayer/security/glass/colony{
	density = 0;
	dir = 1;
	icon_state = "door_open";
	name = "\improper Marshal Office Armory"
	},
/turf/open/floor/dark,
/area/bigredv2/outside/marshal_office)
"br" = (
/obj/structure/pipes/standard/simple/hidden/green,
/turf/open/floor/delivery,
/area/bigredv2/outside/marshal_office)
"bs" = (
/obj/structure/closet/secure_closet/marshal,
/turf/open/floor/dark,
/area/bigredv2/outside/marshal_office)
"bx" = (
/obj/structure/machinery/computer/secure_data,
/obj/structure/surface/table,
/turf/open/floor/dark,
/area/bigredv2/outside/marshal_office)
"by" = (
/turf/open/floor/bcircuit,
/area/bigredv2/outside/marshal_office)
"bA" = (
/obj/structure/machinery/computer/cameras,
/obj/structure/surface/table,
/turf/open/floor/bcircuit,
/area/bigredv2/outside/marshal_office)
"bB" = (
/obj/structure/surface/table,
/obj/item/ore/diamond,
/obj/item/ore/uranium,
/turf/open/floor/bcircuit,
/area/bigredv2/outside/marshal_office)
"bD" = (
/obj/effect/decal/warning_stripes{
	icon_state = "S";
	pixel_y = -1
	},
/turf/open/floor/red/north,
/area/bigredv2/outside/marshal_office)
"bE" = (
/turf/open/floor/redcorner/west,
/area/bigredv2/outside/marshal_office)
"bF" = (
/obj/structure/pipes/standard/simple/hidden/green,
/turf/open/floor/redcorner,
/area/bigredv2/outside/marshal_office)
"bG" = (
/obj/structure/window/framed/solaris/reinforced,
/turf/open/floor/plating,
/area/bigredv2/outside/marshal_office)
"bL" = (
/obj/structure/window_frame/solaris,
/obj/item/shard,
/obj/item/stack/rods,
/turf/open/floor/plating,
/area/bigredv2/outside/marshal_office)
"bM" = (
/obj/structure/machinery/camera/autoname{
	dir = 4
	},
/turf/open/floor/bcircuit,
/area/bigredv2/outside/marshal_office)
"bN" = (
/obj/structure/surface/table,
/obj/item/device/radio,
/turf/open/floor/bcircuit,
/area/bigredv2/outside/marshal_office)
"bO" = (
/turf/open/mars/mars_dirt_13,
/area/bigredv2/outside/n)
"bP" = (
/obj/effect/decal/cleanable/dirt,
/turf/open/floor/redcorner/west,
/area/bigredv2/outside/marshal_office)
"bQ" = (
/obj/structure/surface/table/reinforced,
/obj/structure/machinery/door/window/brigdoor/westright,
/turf/open/floor/vault2/west,
/area/bigredv2/outside/marshal_office)
"bR" = (
/obj/effect/decal/cleanable/dirt,
/obj/effect/landmark/crap_item,
/turf/open/floor/dark,
/area/bigredv2/outside/marshal_office)
"bV" = (
/obj/structure/pipes/standard/simple/hidden/green{
	dir = 4
	},
/turf/open/floor/dark,
/area/bigredv2/outside/marshal_office)
"bW" = (
/obj/structure/pipes/standard/simple/hidden/green{
	dir = 4
	},
/obj/structure/machinery/door/airlock/almayer/security/glass/colony{
	icon_state = "door_locked";
	name = "\improper Marshal Office Armory"
	},
/turf/open/floor/dark,
/area/bigredv2/outside/marshal_office)
"bX" = (
/obj/structure/surface/table,
/obj/item/ore/uranium,
/turf/open/floor/bcircuit,
/area/bigredv2/outside/marshal_office)
"bY" = (
/obj/structure/machinery/light{
	dir = 8
	},
/obj/effect/decal/warning_stripes{
	icon_state = "E";
	pixel_x = 1
	},
/turf/open/floor/red/west,
/area/bigredv2/outside/marshal_office)
"bZ" = (
/obj/effect/landmark/static_comms/net_one,
/turf/open/floor/bcircuit,
/area/bigredv2/outside/marshal_office)
"ca" = (
/obj/effect/decal/warning_stripes{
	icon_state = "SE-out";
	pixel_x = 1;
	pixel_y = -1
	},
/turf/open/floor/red/northwest,
/area/bigredv2/outside/marshal_office)
"cb" = (
/turf/open/floor/asteroidwarning/northwest,
/area/bigredv2/outside/n)
"cg" = (
/obj/structure/pipes/standard/simple/hidden/green,
/obj/effect/decal/cleanable/dirt,
/turf/open/floor/dark,
/area/bigredv2/outside/marshal_office)
"ch" = (
/obj/effect/decal/cleanable/dirt,
/obj/structure/machinery/computer/prisoner,
/turf/open/floor/dark,
/area/bigredv2/outside/marshal_office)
"ci" = (
/obj/structure/machinery/light,
/turf/open/floor/dark,
/area/bigredv2/outside/marshal_office)
"cj" = (
/obj/effect/decal/warning_stripes{
	icon_state = "N";
	pixel_y = 1
	},
/turf/open/floor/red,
/area/bigredv2/outside/marshal_office)
"ck" = (
/obj/effect/decal/warning_stripes{
	icon_state = "NW-out";
	pixel_x = -1;
	pixel_y = 1
	},
/turf/open/floor/red/southeast,
/area/bigredv2/outside/marshal_office)
"cl" = (
/obj/effect/decal/cleanable/dirt,
/obj/effect/landmark/corpsespawner/prison_security,
/obj/effect/decal/cleanable/blood,
/obj/item/ammo_casing/shell,
/obj/item/weapon/gun/shotgun/pump/dual_tube/cmb,
/turf/open/floor/redcorner/west,
/area/bigredv2/outside/marshal_office)
"cm" = (
/obj/structure/pipes/standard/simple/hidden/green,
/obj/effect/decal/cleanable/dirt,
/obj/item/ammo_casing/shell,
/turf/open/floor/redcorner,
/area/bigredv2/outside/marshal_office)
"cn" = (
/obj/structure/surface/table/reinforced,
/obj/structure/machinery/door/window/brigdoor/southright,
/turf/open/floor/vault2/west,
/area/bigredv2/outside/marshal_office)
"co" = (
/obj/structure/window_frame/solaris,
/obj/item/shard,
/turf/open/floor/plating,
/area/bigredv2/outside/marshal_office)
"cq" = (
/turf/open/floor/asteroidwarning/north,
/area/bigredv2/outside/n)
"cr" = (
/obj/item/ammo_casing/shell,
/turf/open/floor/redcorner/west,
/area/bigredv2/outside/marshal_office)
"cs" = (
/obj/structure/pipes/standard/simple/hidden/green,
/turf/open/floor,
/area/bigredv2/outside/marshal_office)
"ct" = (
/obj/structure/closet/hydrant{
	pixel_y = 32
	},
/turf/open/floor/redcorner/east,
/area/bigredv2/outside/marshal_office)
"cu" = (
/obj/effect/landmark/survivor_spawner,
/turf/open/floor/redcorner/east,
/area/bigredv2/outside/marshal_office)
"cy" = (
/obj/structure/machinery/light{
	dir = 1
	},
/turf/open/floor/redcorner/east,
/area/bigredv2/outside/marshal_office)
"cz" = (
/obj/structure/pipes/standard/simple/hidden/green{
	dir = 4
	},
/turf/open/floor/red/west,
/area/bigredv2/outside/marshal_office)
"cA" = (
/obj/structure/pipes/standard/simple/hidden/green{
	dir = 4
	},
/turf/open/floor/redcorner/east,
/area/bigredv2/outside/marshal_office)
"cC" = (
/obj/structure/pipes/standard/simple/hidden/green{
	dir = 4
	},
/obj/effect/decal/cleanable/dirt,
/turf/open/floor/redcorner/east,
/area/bigredv2/outside/marshal_office)
"cE" = (
/obj/structure/pipes/standard/manifold/fourway/hidden/green,
/obj/effect/landmark/crap_item,
/turf/open/floor,
/area/bigredv2/outside/marshal_office)
"cF" = (
/obj/structure/pipes/standard/simple/hidden/green{
	dir = 4
	},
/turf/open/floor,
/area/bigredv2/outside/marshal_office)
"cL" = (
/obj/effect/decal/cleanable/dirt,
/obj/structure/pipes/standard/manifold/hidden/green{
	dir = 1
	},
/turf/open/floor,
/area/bigredv2/outside/marshal_office)
"cM" = (
/obj/structure/pipes/standard/simple/hidden/green{
	dir = 4
	},
/obj/effect/decal/cleanable/dirt,
/obj/item/clothing/shoes/black,
/turf/open/floor,
/area/bigredv2/outside/marshal_office)
"cN" = (
/obj/structure/machinery/door/airlock/multi_tile/almayer/generic{
	dir = 1;
	name = "\improper Marshal Office"
	},
/turf/open/floor/red/west,
/area/bigredv2/outside/marshal_office)
"cO" = (
/obj/effect/decal/cleanable/dirt,
/obj/effect/decal/cleanable/blood{
	dir = 4;
	icon_state = "gib6"
	},
/turf/open/floor/redcorner,
/area/bigredv2/outside/marshal_office)
"cP" = (
/obj/effect/decal/cleanable/dirt,
/obj/effect/landmark/corpsespawner/prisoner,
/obj/effect/decal/cleanable/blood,
/obj/item/tool/kitchen/knife,
/turf/open/floor/redcorner,
/area/bigredv2/outside/marshal_office)
"cR" = (
/obj/structure/pipes/vents/pump{
	dir = 1
	},
/turf/open/floor/redcorner,
/area/bigredv2/outside/marshal_office)
"cS" = (
/obj/structure/machinery/alarm{
	dir = 1;
	pixel_y = -30
	},
/turf/open/floor/redcorner,
/area/bigredv2/outside/marshal_office)
"cT" = (
/obj/effect/decal/cleanable/dirt,
/obj/item/frame/table,
/obj/structure/pipes/standard/simple/hidden/green,
/turf/open/floor/redcorner,
/area/bigredv2/outside/marshal_office)
"cU" = (
/obj/structure/machinery/door/airlock/almayer/security/glass/colony{
	density = 0;
	dir = 1;
	icon_state = "door_open";
	name = "\improper Marshal Office Holding Cell"
	},
/turf/open/floor/dark,
/area/bigredv2/outside/marshal_office)
"cV" = (
/obj/structure/machinery/door/airlock/almayer/security/glass/colony{
	dir = 1;
	icon_state = "door_locked";
	name = "\improper Marshal Office Holding Cell"
	},
/turf/open/floor/dark,
/area/bigredv2/outside/marshal_office)
"cW" = (
/obj/structure/machinery/door/airlock/almayer/security/glass/colony{
	dir = 1;
	name = "\improper Marshal Office Checkpoint"
	},
/turf/open/floor/redfull/northwest,
/area/bigredv2/outside/marshal_office)
"cX" = (
/obj/effect/decal/cleanable/dirt,
/obj/structure/pipes/standard/simple/hidden/green,
/obj/structure/machinery/door/airlock/multi_tile/almayer/generic{
	name = "\improper Marshal Office"
	},
/turf/open/floor,
/area/bigredv2/outside/marshal_office)
"cY" = (
/turf/open/floor,
/area/bigredv2/outside/marshal_office)
"cZ" = (
/turf/open/floor/dark,
/area/bigredv2/outside/marshal_office)
"db" = (
/obj/structure/machinery/door_control{
	id = "Marshal Offices";
	name = "Storm Shutters";
	pixel_x = -32
	},
/turf/open/floor/redfull/northwest,
/area/bigredv2/outside/marshal_office)
"dc" = (
/obj/structure/surface/table,
/turf/open/floor/redfull/northwest,
/area/bigredv2/outside/marshal_office)
"dd" = (
/obj/effect/decal/cleanable/dirt,
/obj/structure/pipes/standard/simple/hidden/green,
/turf/open/floor,
/area/bigredv2/outside/marshal_office)
"de" = (
/obj/structure/closet/secure_closet/brig,
/turf/open/floor/dark,
/area/bigredv2/outside/marshal_office)
"df" = (
/obj/structure/bed,
/turf/open/floor/dark,
/area/bigredv2/outside/marshal_office)
"dg" = (
/obj/structure/machinery/light{
	dir = 8
	},
/turf/open/floor/redfull/northwest,
/area/bigredv2/outside/marshal_office)
"dh" = (
/obj/structure/bed/chair/office/dark{
	dir = 4
	},
/turf/open/floor/redfull/northwest,
/area/bigredv2/outside/marshal_office)
"di" = (
/obj/effect/decal/cleanable/dirt,
/obj/effect/landmark/survivor_spawner,
/turf/open/floor,
/area/bigredv2/outside/marshal_office)
"dj" = (
/turf/closed/wall/solaris/reinforced,
/area/bigredv2/outside/medical)
"dk" = (
/obj/structure/pipes/standard/simple/hidden/green,
/obj/structure/machinery/door/airlock/multi_tile/almayer/generic{
	name = "\improper Marshal Office"
	},
/turf/open/floor,
/area/bigredv2/outside/marshal_office)
"do" = (
/turf/open/mars/mars_dirt_10,
/area/bigredv2/outside/n)
"ea" = (
/obj/structure/surface/rack,
/obj/item/ammo_magazine/revolver/cmb,
/turf/open/floor/vault2/west,
/area/bigredv2/outside/marshal_office)
"fh" = (
/obj/structure/machinery/door/airlock/almayer/security/glass/colony{
	dir = 1;
	name = "\improper Marshal Office Evidence Room"
	},
/turf/open/floor/delivery,
/area/bigredv2/outside/marshal_office)
"gl" = (
/obj/structure/pipes/standard/simple/hidden/green{
	dir = 4
	},
/obj/effect/decal/cleanable/dirt,
/obj/effect/decal/cleanable/dirt,
/obj/effect/landmark/objective_landmark/far,
/turf/open/floor,
/area/bigredv2/outside/marshal_office)
"gu" = (
/turf/open/mars_cave/mars_dirt_4,
/area/bigredv2/outside/n)
"gJ" = (
/obj/structure/closet/secure_closet/brig,
/obj/effect/landmark/objective_landmark/close,
/turf/open/floor/dark,
/area/bigredv2/outside/marshal_office)
"hc" = (
/obj/structure/surface/rack,
/turf/open/floor/vault2/west,
/area/bigredv2/outside/marshal_office)
"if" = (
/turf/open/floor/asteroidwarning/east,
/area/bigredv2/outside/n)
"ip" = (
/obj/structure/surface/table/reinforced,
/obj/structure/machinery/door/window/brigdoor/eastleft,
/obj/item/weapon/shield/riot,
/turf/open/floor/vault2/west,
/area/bigredv2/outside/marshal_office)
"ix" = (
/obj/structure/closet/secure_closet/brig,
/obj/effect/landmark/objective_landmark/far,
/turf/open/floor/dark,
/area/bigredv2/outside/marshal_office)
"jj" = (
/obj/structure/pipes/standard/simple/hidden/green,
/obj/structure/machinery/door/airlock/almayer/medical/glass/colony{
	dir = 1;
	name = "\improper Marshal Office Prison"
	},
/turf/open/floor/whitegreenfull/northeast,
/area/bigredv2/outside/marshal_office)
"jn" = (
/obj/item/shard,
/turf/open/floor/redcorner/east,
/area/bigredv2/outside/marshal_office)
"jo" = (
/obj/structure/machinery/light{
	dir = 1
	},
/obj/item/ammo_casing/shell,
/turf/open/floor/dark,
/area/bigredv2/outside/marshal_office)
"jq" = (
/obj/structure/machinery/camera/autoname,
/obj/effect/decal/warning_stripes{
	icon_state = "SW-out";
	pixel_x = -1;
	pixel_y = -1
	},
/turf/open/floor/red/northeast,
/area/bigredv2/outside/marshal_office)
"jC" = (
/obj/structure/pipes/standard/simple/hidden/green{
	dir = 4
	},
/obj/structure/machinery/camera/autoname,
/turf/open/floor/redcorner/east,
/area/bigredv2/outside/marshal_office)
"jW" = (
/obj/effect/landmark/corpsespawner/prison_security,
/obj/effect/decal/cleanable/blood,
/turf/open/floor/dark,
/area/bigredv2/outside/marshal_office)
"lU" = (
/obj/effect/decal/cleanable/dirt,
/obj/item/shard,
/turf/open/floor/redcorner/east,
/area/bigredv2/outside/marshal_office)
"mB" = (
/obj/structure/machinery/deployable/barrier,
/turf/open/floor/vault2/west,
/area/bigredv2/outside/marshal_office)
"np" = (
/obj/structure/pipes/standard/simple/hidden/green,
/obj/structure/machinery/door/airlock/almayer/security/glass/colony{
	dir = 1;
	icon_state = "door_locked";
	name = "\improper Marshal Office Prison"
	},
/turf/open/floor/whitegreenfull/northeast,
/area/bigredv2/outside/marshal_office)
"nV" = (
/obj/structure/pipes/vents/pump,
/obj/effect/decal/cleanable/dirt,
/turf/open/floor/dark,
/area/bigredv2/outside/marshal_office)
"ov" = (
/obj/structure/pipes/standard/manifold/hidden/green{
	dir = 8
	},
/obj/item/ammo_casing/shell,
/turf/open/floor/dark,
/area/bigredv2/outside/marshal_office)
"pw" = (
/obj/item/shard,
/turf/open/floor/dark,
/area/bigredv2/outside/marshal_office)
"pG" = (
/obj/structure/surface/table,
/obj/item/ammo_magazine/shotgun/buckshot,
/obj/structure/machinery/camera/autoname,
/turf/open/floor/dark,
/area/bigredv2/outside/marshal_office)
"qm" = (
/obj/structure/bed,
/obj/effect/landmark/objective_landmark/medium,
/turf/open/floor/dark,
/area/bigredv2/outside/marshal_office)
"qG" = (
/obj/structure/surface/rack,
/obj/item/weapon/gun/revolver/cmb,
/turf/open/floor/vault2/west,
/area/bigredv2/outside/marshal_office)
"qM" = (
/obj/structure/surface/table,
/obj/item/clothing/mask/gas,
/obj/item/clothing/mask/gas,
/turf/open/floor/dark,
/area/bigredv2/outside/marshal_office)
"rC" = (
/obj/effect/decal/warning_stripes{
	icon_state = "W";
	layer = 2.5;
	pixel_x = -1
	},
/turf/open/floor/red/east,
/area/bigredv2/outside/marshal_office)
"rL" = (
/obj/effect/decal/warning_stripes{
	icon_state = "NE-out";
	pixel_x = 1;
	pixel_y = 1
	},
/turf/open/floor/red/southwest,
/area/bigredv2/outside/marshal_office)
"sZ" = (
/obj/structure/bed/chair{
	dir = 8
	},
/obj/effect/landmark/corpsespawner/prisoner,
/turf/open/floor/white,
/area/bigredv2/outside/marshal_office)
"tu" = (
/obj/structure/surface/rack,
/obj/effect/landmark/item_pool_spawner/survivor_ammo/buckshot,
/obj/effect/landmark/item_pool_spawner/survivor_ammo/buckshot,
/turf/open/floor/dark,
/area/bigredv2/outside/marshal_office)
"uc" = (
/obj/effect/landmark/corpsespawner/prisoner,
/obj/effect/decal/cleanable/blood,
/turf/open/floor/dark,
/area/bigredv2/outside/marshal_office)
"uy" = (
/obj/structure/machinery/door/airlock/almayer/medical/glass/colony{
	dir = 1;
	name = "\improper Marshal Office Prison"
	},
/turf/open/floor/whitegreenfull/northeast,
/area/bigredv2/outside/marshal_office)
"vi" = (
/obj/effect/decal/cleanable/dirt,
/obj/item/shard,
/turf/open/floor/dark,
/area/bigredv2/outside/marshal_office)
"wm" = (
/obj/effect/decal/cleanable/dirt,
/obj/item/shard,
/turf/open/floor/redcorner,
/area/bigredv2/outside/marshal_office)
"wL" = (
/obj/structure/machinery/light,
/turf/open/floor/bcircuit,
/area/bigredv2/outside/marshal_office)
"xk" = (
/obj/effect/decal/cleanable/dirt,
/obj/effect/decal/cleanable/blood{
	dir = 4;
	icon_state = "gib6"
	},
/obj/item/ammo_casing/shell,
/turf/open/floor/dark,
/area/bigredv2/outside/marshal_office)
"xq" = (
/obj/effect/decal/cleanable/blood,
/obj/effect/decal/cleanable/dirt,
/turf/open/floor/white,
/area/bigredv2/outside/marshal_office)
"yb" = (
/obj/structure/window_frame/solaris,
/turf/open/floor/plating,
/area/bigredv2/outside/marshal_office)
"yx" = (
/obj/structure/machinery/door/airlock/almayer/generic{
	dir = 1;
	name = "\improper Marshal Office Prison Toilet"
	},
/turf/open/floor/freezerfloor,
/area/bigredv2/outside/marshal_office)
"za" = (
/obj/effect/decal/cleanable/dirt,
/obj/effect/landmark/objective_landmark/medium,
/turf/open/floor/dark,
/area/bigredv2/outside/marshal_office)
"zv" = (
/obj/structure/bed/chair{
	dir = 4
	},
/obj/effect/decal/cleanable/blood,
/turf/open/floor/white,
/area/bigredv2/outside/marshal_office)
"zD" = (
/obj/structure/machinery/door/airlock/multi_tile/almayer/generic{
	name = "\improper Marshal Office Brig"
	},
/turf/open/floor/delivery,
/area/bigredv2/outside/marshal_office)
"BS" = (
/obj/structure/machinery/power/apc,
/obj/structure/machinery/camera/autoname{
	dir = 1
	},
/turf/open/floor/dark,
/area/bigredv2/outside/marshal_office)
"Ek" = (
/obj/structure/surface/rack,
/obj/item/clothing/suit/armor/riot,
/turf/open/floor/dark,
/area/bigredv2/outside/marshal_office)
"FA" = (
/obj/effect/decal/cleanable/dirt,
/obj/effect/landmark/corpsespawner/prisoner,
/obj/effect/decal/cleanable/blood,
/obj/item/tool/screwdriver,
/turf/open/floor/dark,
/area/bigredv2/outside/marshal_office)
"Gs" = (
/obj/effect/landmark/corpsespawner/prisoner,
/obj/effect/decal/cleanable/blood,
/turf/open/floor/redcorner,
/area/bigredv2/outside/marshal_office)
"Hl" = (
/obj/structure/surface/rack,
/obj/item/weapon/gun/shotgun/pump/dual_tube/cmb,
/turf/open/floor/dark,
/area/bigredv2/outside/marshal_office)
"Ho" = (
/obj/structure/pipes/standard/manifold/hidden/green,
/obj/effect/decal/cleanable/dirt,
/turf/open/floor,
/area/bigredv2/outside/marshal_office)
"HS" = (
/obj/structure/surface/rack,
/obj/item/clothing/accessory/storage/black_vest,
/turf/open/floor/dark,
/area/bigredv2/outside/marshal_office)
"Io" = (
/obj/structure/closet/l3closet/security,
/obj/structure/machinery/light{
	dir = 1
	},
/turf/open/floor/vault2/west,
/area/bigredv2/outside/marshal_office)
"Kb" = (
/obj/structure/pipes/standard/simple/hidden/green{
	dir = 4
	},
/obj/structure/machinery/door_control{
	id = "Marshal Offices";
	name = "Storm Shutters";
	pixel_y = 24
	},
/turf/open/floor/redcorner/east,
/area/bigredv2/outside/marshal_office)
"MH" = (
/obj/structure/mirror{
	icon_state = "mirror_broke";
	pixel_x = 30
	},
/obj/item/tool/soap/deluxe,
/turf/open/floor/freezerfloor,
/area/bigredv2/outside/marshal_office)
"MM" = (
/obj/structure/window/framed/solaris/reinforced,
/obj/structure/machinery/door/poddoor/shutters/almayer{
	id = "Marshal Offices";
	name = "\improper Marshal Offices Shutters"
	},
/turf/open/floor/plating,
/area/bigredv2/outside/medical)
"No" = (
/obj/effect/decal/warning_stripes{
	icon_state = "E";
	pixel_x = 1
	},
/turf/open/floor/red/west,
/area/bigredv2/outside/marshal_office)
"Ow" = (
/obj/structure/surface/table,
/obj/effect/landmark/item_pool_spawner/survivor_ammo/buckshot,
/turf/open/floor/dark,
/area/bigredv2/outside/marshal_office)
"Qs" = (
/obj/structure/surface/rack,
/obj/item/ammo_magazine/shotgun,
/obj/effect/decal/cleanable/dirt,
/turf/open/floor/dark,
/area/bigredv2/outside/marshal_office)
"RJ" = (
/obj/effect/landmark/lv624/xeno_tunnel,
/turf/open/floor/asteroidfloor/north,
/area/bigredv2/outside/n)
"Sa" = (
/obj/effect/decal/cleanable/dirt,
/obj/effect/decal/cleanable/dirt,
/obj/effect/landmark/objective_landmark/science,
/turf/open/floor/dark,
/area/bigredv2/outside/marshal_office)
"Sf" = (
/obj/structure/machinery/door/airlock/almayer/security/glass/colony{
	density = 0;
	dir = 1;
	icon_state = "door_open";
	name = "\improper Marshal Office Prison"
	},
/turf/open/floor/whitegreenfull/northeast,
/area/bigredv2/outside/marshal_office)
"Sj" = (
/obj/structure/surface/table,
/obj/item/clothing/head/beret/sec/warden,
/turf/open/floor/dark,
/area/bigredv2/outside/marshal_office)
"ST" = (
/obj/structure/machinery/door/airlock/almayer/security/glass/colony{
	dir = 1;
	icon_state = "door_locked";
	name = "\improper Marshal Office Prison"
	},
/turf/open/floor/whitegreenfull/northeast,
/area/bigredv2/outside/marshal_office)
"VX" = (
/obj/structure/machinery/light{
	dir = 4
	},
/turf/open/floor/whitegreen/east,
/area/bigredv2/outside/marshal_office)
"YT" = (
/obj/structure/surface/rack,
/obj/structure/machinery/light{
	dir = 1
	},
/obj/item/ammo_magazine/revolver/cmb,
/turf/open/floor/vault2/west,
/area/bigredv2/outside/marshal_office)

(1,1,1) = {"
aa
ab
ab
uy
ab
ab
ST
aO
aY
bh
ah
by
bM
by
by
at
cz
cN
ah
ah
ah
dj
"}
(2,1,1) = {"
ab
aa
aa
at
aw
aw
ah
aP
aY
bi
ah
by
cZ
cZ
cZ
at
cA
bi
bG
cZ
gJ
dj
"}
(3,1,1) = {"
ac
aa
xq
at
at
at
ah
aP
aY
bi
ah
bA
cZ
cZ
cZ
fh
cA
cO
cU
cZ
ci
dj
"}
(4,1,1) = {"
ac
aa
aa
at
ax
az
ah
aP
aZ
bi
ah
bB
bN
bX
wL
at
cA
cP
bG
cZ
df
dj
"}
(5,1,1) = {"
sZ
ak
ap
jj
ap
ap
np
aQ
ba
bj
ah
at
at
at
at
at
Kb
bk
ah
ah
ah
dj
"}
(6,1,1) = {"
zv
ab
ab
at
aw
aw
ah
aR
bb
bk
ah
ca
No
bY
rL
cZ
cA
bk
bG
cZ
ix
dj
"}
(7,1,1) = {"
ac
ab
aa
at
at
at
ah
aR
bb
bl
ah
bD
by
bZ
cj
cZ
jC
bk
cV
cZ
ci
dj
"}
(8,1,1) = {"
af
ab
ab
at
ax
az
ah
aR
bc
bk
ah
bD
by
by
cj
cZ
cC
wm
bL
cZ
df
dj
"}
(9,1,1) = {"
aa
aa
aa
uy
ab
ab
Sf
aR
bc
Gs
ah
jq
rC
rC
ck
cZ
cC
bi
ah
ah
ah
dj
"}
(10,1,1) = {"
VX
al
al
at
aw
aw
ah
aR
bb
bh
ah
cZ
cZ
cZ
cZ
cZ
cC
bi
bG
cZ
de
dj
"}
(11,1,1) = {"
ah
am
aq
at
at
at
ah
aR
bb
bk
zD
bE
bP
bP
cl
cr
bb
bi
cU
cZ
ci
dj
"}
(12,1,1) = {"
ah
MH
ar
yx
ay
aA
ah
aR
bd
bn
br
bF
bn
bn
cm
cs
cE
cR
bG
uc
qm
dj
"}
(13,1,1) = {"
ah
ah
ah
ah
ah
ah
ah
ah
ah
ah
ah
bG
bQ
bG
ah
ct
cF
cS
ah
ah
ah
dj
"}
(14,1,1) = {"
ai
ai
if
RJ
ah
aB
mB
mB
mB
ah
bs
cZ
cZ
qM
bG
aP
gl
bi
bL
cZ
de
dj
"}
(15,1,1) = {"
aj
aj
aj
cq
ah
Io
cZ
cZ
cZ
ah
Ow
cZ
cZ
qM
bG
cu
bc
wm
cV
cZ
ci
dj
"}
(16,1,1) = {"
aj
aj
aj
cq
ah
aD
cZ
HS
cZ
ah
Ow
cZ
aN
cZ
cn
aP
bb
bk
bG
cZ
df
dj
"}
(17,1,1) = {"
aj
aj
bO
cq
ah
aD
aN
Hl
cZ
ah
pG
xk
bR
Ek
co
lU
bb
bk
ah
ah
ah
dj
"}
(18,1,1) = {"
aj
aj
do
ai
ah
hc
za
Qs
BS
ah
Sj
FA
vi
Ek
yb
jn
cF
bk
cW
db
dg
MM
"}
(19,1,1) = {"
aj
bO
gu
ai
ah
ea
aN
tu
ci
ah
jo
aN
Sa
pw
bL
aR
bb
bk
bG
dc
dh
MM
"}
(20,1,1) = {"
bO
gu
ai
ai
ah
qG
aN
nV
bg
bp
bg
bg
ov
cg
bp
aQ
Ho
bk
ah
bG
bG
dj
"}
(21,1,1) = {"
cb
ai
ai
ai
ah
YT
cZ
aN
cZ
ah
bx
jW
bV
ch
ah
aR
cL
cT
cX
dd
dd
dk
"}
(22,1,1) = {"
cq
ah
ah
ah
ah
ah
ah
ip
ah
ah
ah
bL
bW
bG
ah
cy
cM
bk
cY
cY
di
cY
"}
